"filename", "language", "Properties", "Batch", "Docker", "Java", "XML", "comment", "blank", "total"
"h:\HUST\Thesis\GioiMon-Backend\gm-post\.mvn\wrapper\maven-wrapper.properties", "Properties", 2, 0, 0, 0, 0, 0, 1, 3
"h:\HUST\Thesis\GioiMon-Backend\gm-post\Dockerfile", "Docker", 0, 0, 10, 0, 0, 0, 1, 11
"h:\HUST\Thesis\GioiMon-Backend\gm-post\mvnw.cmd", "Batch", 0, 118, 0, 0, 0, 51, 37, 206
"h:\HUST\Thesis\GioiMon-Backend\gm-post\pom.xml", "XML", 0, 0, 0, 0, 136, 4, 6, 146
"h:\HUST\Thesis\GioiMon-Backend\gm-post\src\main\java\hust\project\gioimon\gm_post\GmPostApplication.java", "Java", 0, 0, 0, 16, 0, 0, 4, 20
"h:\HUST\Thesis\GioiMon-Backend\gm-post\src\main\java\hust\project\gioimon\gm_post\client\check_permission\CheckPermissionAnno.java", "Java", 0, 0, 0, 11, 0, 0, 3, 14
"h:\HUST\Thesis\GioiMon-Backend\gm-post\src\main\java\hust\project\gioimon\gm_post\client\check_permission\CheckPermissionAspect.java", "Java", 0, 0, 0, 61, 0, 1, 8, 70
"h:\HUST\Thesis\GioiMon-Backend\gm-post\src\main\java\hust\project\gioimon\gm_post\client\check_permission\CheckPermissionResponseDTO.java", "Java", 0, 0, 0, 13, 0, 0, 4, 17
"h:\HUST\Thesis\GioiMon-Backend\gm-post\src\main\java\hust\project\gioimon\gm_post\client\exceptions\ErrorsDefinition.java", "Java", 0, 0, 0, 80, 0, 0, 16, 96
"h:\HUST\Thesis\GioiMon-Backend\gm-post\src\main\java\hust\project\gioimon\gm_post\client\exceptions\TypeError.java", "Java", 0, 0, 0, 7, 0, 0, 5, 12
"h:\HUST\Thesis\GioiMon-Backend\gm-post\src\main\java\hust\project\gioimon\gm_post\client\feign_client\UserClient.java", "Java", 0, 0, 0, 19, 0, 0, 3, 22
"h:\HUST\Thesis\GioiMon-Backend\gm-post\src\main\java\hust\project\gioimon\gm_post\client\model\GetPostStoryRequest.java", "Java", 0, 0, 0, 8, 0, 0, 3, 11
"h:\HUST\Thesis\GioiMon-Backend\gm-post\src\main\java\hust\project\gioimon\gm_post\client\model\ResponseData.java", "Java", 0, 0, 0, 32, 0, 0, 10, 42
"h:\HUST\Thesis\GioiMon-Backend\gm-post\src\main\java\hust\project\gioimon\gm_post\client\model\TopPostStoryResponse.java", "Java", 0, 0, 0, 9, 0, 0, 3, 12
"h:\HUST\Thesis\GioiMon-Backend\gm-post\src\main\java\hust\project\gioimon\gm_post\client\utils\Scope.java", "Java", 0, 0, 0, 7, 0, 0, 3, 10
"h:\HUST\Thesis\GioiMon-Backend\gm-post\src\main\java\hust\project\gioimon\gm_post\service\cache\ListPostCache.java", "Java", 0, 0, 0, 37, 0, 0, 5, 42
"h:\HUST\Thesis\GioiMon-Backend\gm-post\src\main\java\hust\project\gioimon\gm_post\service\constants\PostConstant.java", "Java", 0, 0, 0, 5, 0, 0, 3, 8
"h:\HUST\Thesis\GioiMon-Backend\gm-post\src\main\java\hust\project\gioimon\gm_post\service\controllers\CommentController.java", "Java", 0, 0, 0, 34, 0, 0, 4, 38
"h:\HUST\Thesis\GioiMon-Backend\gm-post\src\main\java\hust\project\gioimon\gm_post\service\controllers\ListPostController.java", "Java", 0, 0, 0, 39, 0, 0, 6, 45
"h:\HUST\Thesis\GioiMon-Backend\gm-post\src\main\java\hust\project\gioimon\gm_post\service\controllers\PostController.java", "Java", 0, 0, 0, 51, 0, 0, 5, 56
"h:\HUST\Thesis\GioiMon-Backend\gm-post\src\main\java\hust\project\gioimon\gm_post\service\converter\CommentConverter.java", "Java", 0, 0, 0, 25, 0, 0, 3, 28
"h:\HUST\Thesis\GioiMon-Backend\gm-post\src\main\java\hust\project\gioimon\gm_post\service\converter\PostConverter.java", "Java", 0, 0, 0, 33, 0, 0, 4, 37
"h:\HUST\Thesis\GioiMon-Backend\gm-post\src\main\java\hust\project\gioimon\gm_post\service\converter\StringListConverter.java", "Java", 0, 0, 0, 18, 0, 0, 7, 25
"h:\HUST\Thesis\GioiMon-Backend\gm-post\src\main\java\hust\project\gioimon\gm_post\service\exceptions\GlobalExceptionHandler.java", "Java", 0, 0, 0, 27, 0, 1, 3, 31
"h:\HUST\Thesis\GioiMon-Backend\gm-post\src\main\java\hust\project\gioimon\gm_post\service\exceptions\custom\ApplicationException.java", "Java", 0, 0, 0, 6, 0, 0, 2, 8
"h:\HUST\Thesis\GioiMon-Backend\gm-post\src\main\java\hust\project\gioimon\gm_post\service\exceptions\custom\UserDoesNotExistException.java", "Java", 0, 0, 0, 6, 0, 0, 2, 8
"h:\HUST\Thesis\GioiMon-Backend\gm-post\src\main\java\hust\project\gioimon\gm_post\service\exceptions\custom\UsernameExistedException.java", "Java", 0, 0, 0, 6, 0, 0, 3, 9
"h:\HUST\Thesis\GioiMon-Backend\gm-post\src\main\java\hust\project\gioimon\gm_post\service\model\dto\request\AddCoinReqDTO.java", "Java", 0, 0, 0, 14, 0, 0, 3, 17
"h:\HUST\Thesis\GioiMon-Backend\gm-post\src\main\java\hust\project\gioimon\gm_post\service\model\dto\request\CreatePostDTO.java", "Java", 0, 0, 0, 17, 0, 0, 4, 21
"h:\HUST\Thesis\GioiMon-Backend\gm-post\src\main\java\hust\project\gioimon\gm_post\service\model\dto\request\GetDetailPostDTO.java", "Java", 0, 0, 0, 8, 0, 0, 3, 11
"h:\HUST\Thesis\GioiMon-Backend\gm-post\src\main\java\hust\project\gioimon\gm_post\service\model\dto\request\LoginRequestDTO.java", "Java", 0, 0, 0, 13, 0, 0, 3, 16
"h:\HUST\Thesis\GioiMon-Backend\gm-post\src\main\java\hust\project\gioimon\gm_post\service\model\dto\request\PostCommentDTO.java", "Java", 0, 0, 0, 16, 0, 0, 4, 20
"h:\HUST\Thesis\GioiMon-Backend\gm-post\src\main\java\hust\project\gioimon\gm_post\service\model\dto\response\CommentResponseDTO.java", "Java", 0, 0, 0, 21, 0, 0, 3, 24
"h:\HUST\Thesis\GioiMon-Backend\gm-post\src\main\java\hust\project\gioimon\gm_post\service\model\dto\response\LoginResponseDTO.java", "Java", 0, 0, 0, 14, 0, 0, 3, 17
"h:\HUST\Thesis\GioiMon-Backend\gm-post\src\main\java\hust\project\gioimon\gm_post\service\model\dto\response\PostResponseDTO.java", "Java", 0, 0, 0, 16, 0, 0, 3, 19
"h:\HUST\Thesis\GioiMon-Backend\gm-post\src\main\java\hust\project\gioimon\gm_post\service\model\entity\CommentCompositeKey.java", "Java", 0, 0, 0, 21, 0, 0, 4, 25
"h:\HUST\Thesis\GioiMon-Backend\gm-post\src\main\java\hust\project\gioimon\gm_post\service\model\entity\Post.java", "Java", 0, 0, 0, 44, 0, 0, 4, 48
"h:\HUST\Thesis\GioiMon-Backend\gm-post\src\main\java\hust\project\gioimon\gm_post\service\model\entity\PostComment.java", "Java", 0, 0, 0, 29, 0, 0, 5, 34
"h:\HUST\Thesis\GioiMon-Backend\gm-post\src\main\java\hust\project\gioimon\gm_post\service\model\entity\PostFavCompositeKey.java", "Java", 0, 0, 0, 18, 0, 0, 3, 21
"h:\HUST\Thesis\GioiMon-Backend\gm-post\src\main\java\hust\project\gioimon\gm_post\service\model\entity\PostFavourite.java", "Java", 0, 0, 0, 25, 0, 0, 3, 28
"h:\HUST\Thesis\GioiMon-Backend\gm-post\src\main\java\hust\project\gioimon\gm_post\service\model\entity\Profile.java", "Java", 0, 0, 0, 31, 0, 0, 4, 35
"h:\HUST\Thesis\GioiMon-Backend\gm-post\src\main\java\hust\project\gioimon\gm_post\service\repository\jdbc\BaseRepository.java", "Java", 0, 0, 0, 52, 0, 0, 3, 55
"h:\HUST\Thesis\GioiMon-Backend\gm-post\src\main\java\hust\project\gioimon\gm_post\service\repository\jdbc\PostJDBCRepository.java", "Java", 0, 0, 0, 17, 0, 0, 3, 20
"h:\HUST\Thesis\GioiMon-Backend\gm-post\src\main\java\hust\project\gioimon\gm_post\service\repository\jpa\ListPostRepository.java", "Java", 0, 0, 0, 11, 0, 0, 3, 14
"h:\HUST\Thesis\GioiMon-Backend\gm-post\src\main\java\hust\project\gioimon\gm_post\service\repository\jpa\PostCommentRepository.java", "Java", 0, 0, 0, 14, 0, 0, 4, 18
"h:\HUST\Thesis\GioiMon-Backend\gm-post\src\main\java\hust\project\gioimon\gm_post\service\repository\jpa\PostFavRepository.java", "Java", 0, 0, 0, 23, 0, 0, 3, 26
"h:\HUST\Thesis\GioiMon-Backend\gm-post\src\main\java\hust\project\gioimon\gm_post\service\repository\jpa\PostRepository.java", "Java", 0, 0, 0, 17, 0, 0, 4, 21
"h:\HUST\Thesis\GioiMon-Backend\gm-post\src\main\java\hust\project\gioimon\gm_post\service\service\ListPostService.java", "Java", 0, 0, 0, 128, 0, 0, 12, 140
"h:\HUST\Thesis\GioiMon-Backend\gm-post\src\main\java\hust\project\gioimon\gm_post\service\service\PostCommentService.java", "Java", 0, 0, 0, 54, 0, 0, 4, 58
"h:\HUST\Thesis\GioiMon-Backend\gm-post\src\main\java\hust\project\gioimon\gm_post\service\service\PostFavouriteService.java", "Java", 0, 0, 0, 51, 0, 1, 8, 60
"h:\HUST\Thesis\GioiMon-Backend\gm-post\src\main\java\hust\project\gioimon\gm_post\service\service\PostService.java", "Java", 0, 0, 0, 41, 0, 0, 6, 47
"h:\HUST\Thesis\GioiMon-Backend\gm-post\src\main\java\hust\project\gioimon\gm_post\service\utils\BaseResponse.java", "Java", 0, 0, 0, 18, 0, 0, 2, 20
"h:\HUST\Thesis\GioiMon-Backend\gm-post\src\main\java\hust\project\gioimon\gm_post\service\utils\GsonUtil.java", "Java", 0, 0, 0, 118, 0, 0, 16, 134
"h:\HUST\Thesis\GioiMon-Backend\gm-post\src\main\java\hust\project\gioimon\gm_post\service\utils\StringUtil.java", "Java", 0, 0, 0, 21, 0, 1, 3, 25
"h:\HUST\Thesis\GioiMon-Backend\gm-post\src\main\java\hust\project\gioimon\gm_post\service\utils\TimeUtil.java", "Java", 0, 0, 0, 6, 0, 0, 2, 8
"h:\HUST\Thesis\GioiMon-Backend\gm-post\src\main\java\hust\project\gioimon\gm_post\service\utils\Validator.java", "Java", 0, 0, 0, 8, 0, 0, 3, 11
"h:\HUST\Thesis\GioiMon-Backend\gm-post\src\main\java\hust\project\gioimon\gm_post\service\utils\network\OkHttpUtil.java", "Java", 0, 0, 0, 141, 0, 0, 15, 156
"h:\HUST\Thesis\GioiMon-Backend\gm-post\src\main\java\hust\project\gioimon\gm_post\service\utils\token\JWTCreator.java", "Java", 0, 0, 0, 37, 0, 0, 8, 45
"h:\HUST\Thesis\GioiMon-Backend\gm-post\src\main\java\hust\project\gioimon\gm_post\service\utils\token\TokenElements.java", "Java", 0, 0, 0, 31, 0, 0, 7, 38
"h:\HUST\Thesis\GioiMon-Backend\gm-post\src\main\java\hust\project\gioimon\gm_post\service\utils\token\TokenUtil.java", "Java", 0, 0, 0, 16, 0, 0, 3, 19
"h:\HUST\Thesis\GioiMon-Backend\gm-post\src\main\resources\application.properties", "Properties", 9, 0, 0, 0, 0, 4, 2, 15
"h:\HUST\Thesis\GioiMon-Backend\gm-post\src\test\java\hust\project\gioimon\gm_post\GmPostApplicationTests.java", "Java", 0, 0, 0, 9, 0, 0, 5, 14
"h:\HUST\Thesis\GioiMon-Backend\gm-post\src\test\java\hust\project\gioimon\gm_post\service\controller\ListPostTests.java", "Java", 0, 0, 0, 106, 0, 0, 12, 118
"Total", "-", 11, 118, 10, 1756, 136, 63, 331, 2425