"filename", "language", "Properties", "XML", "Java", "Batch", "Docker", "comment", "blank", "total"
"h:\HUST\Thesis\GioiMon-Backend\gm-user\.mvn\wrapper\maven-wrapper.properties", "Properties", 2, 0, 0, 0, 0, 0, 1, 3
"h:\HUST\Thesis\GioiMon-Backend\gm-user\Dockerfile", "Docker", 0, 0, 0, 0, 10, 0, 1, 11
"h:\HUST\Thesis\GioiMon-Backend\gm-user\mvnw.cmd", "Batch", 0, 0, 0, 118, 0, 51, 37, 206
"h:\HUST\Thesis\GioiMon-Backend\gm-user\pom.xml", "XML", 0, 125, 0, 0, 0, 3, 6, 134
"h:\HUST\Thesis\GioiMon-Backend\gm-user\src\main\java\hust\project\gioimon\gm_user\GmUserApplication.java", "Java", 0, 0, 13, 0, 0, 0, 3, 16
"h:\HUST\Thesis\GioiMon-Backend\gm-user\src\main\java\hust\project\gioimon\gm_user\client\check_permission\CheckPermissionResponseDTO.java", "Java", 0, 0, 14, 0, 0, 0, 4, 18
"h:\HUST\Thesis\GioiMon-Backend\gm-user\src\main\java\hust\project\gioimon\gm_user\client\exceptions\ErrorsDefinition.java", "Java", 0, 0, 80, 0, 0, 0, 16, 96
"h:\HUST\Thesis\GioiMon-Backend\gm-user\src\main\java\hust\project\gioimon\gm_user\client\exceptions\TypeError.java", "Java", 0, 0, 7, 0, 0, 0, 5, 12
"h:\HUST\Thesis\GioiMon-Backend\gm-user\src\main\java\hust\project\gioimon\gm_user\client\model\ResponseData.java", "Java", 0, 0, 32, 0, 0, 0, 10, 42
"h:\HUST\Thesis\GioiMon-Backend\gm-user\src\main\java\hust\project\gioimon\gm_user\service\constants\PostConstant.java", "Java", 0, 0, 5, 0, 0, 0, 3, 8
"h:\HUST\Thesis\GioiMon-Backend\gm-user\src\main\java\hust\project\gioimon\gm_user\service\controllers\AuthenticationController.java", "Java", 0, 0, 24, 0, 0, 0, 3, 27
"h:\HUST\Thesis\GioiMon-Backend\gm-user\src\main\java\hust\project\gioimon\gm_user\service\controllers\DemoController.java", "Java", 0, 0, 16, 0, 0, 1, 5, 22
"h:\HUST\Thesis\GioiMon-Backend\gm-user\src\main\java\hust\project\gioimon\gm_user\service\controllers\GlobalController.java", "Java", 0, 0, 22, 0, 0, 0, 3, 25
"h:\HUST\Thesis\GioiMon-Backend\gm-user\src\main\java\hust\project\gioimon\gm_user\service\controllers\PaymentController.java", "Java", 0, 0, 29, 0, 0, 0, 3, 32
"h:\HUST\Thesis\GioiMon-Backend\gm-user\src\main\java\hust\project\gioimon\gm_user\service\controllers\ProfileController.java", "Java", 0, 0, 24, 0, 0, 0, 3, 27
"h:\HUST\Thesis\GioiMon-Backend\gm-user\src\main\java\hust\project\gioimon\gm_user\service\converter\IConverter.java", "Java", 0, 0, 4, 0, 0, 0, 2, 6
"h:\HUST\Thesis\GioiMon-Backend\gm-user\src\main\java\hust\project\gioimon\gm_user\service\converter\StringListConverter.java", "Java", 0, 0, 18, 0, 0, 0, 7, 25
"h:\HUST\Thesis\GioiMon-Backend\gm-user\src\main\java\hust\project\gioimon\gm_user\service\converter\UserConverter.java", "Java", 0, 0, 17, 0, 0, 2, 2, 21
"h:\HUST\Thesis\GioiMon-Backend\gm-user\src\main\java\hust\project\gioimon\gm_user\service\exceptions\GlobalExceptionHandler.java", "Java", 0, 0, 27, 0, 0, 1, 3, 31
"h:\HUST\Thesis\GioiMon-Backend\gm-user\src\main\java\hust\project\gioimon\gm_user\service\exceptions\custom\ApplicationException.java", "Java", 0, 0, 6, 0, 0, 0, 2, 8
"h:\HUST\Thesis\GioiMon-Backend\gm-user\src\main\java\hust\project\gioimon\gm_user\service\exceptions\custom\UserDoesNotExistException.java", "Java", 0, 0, 6, 0, 0, 0, 2, 8
"h:\HUST\Thesis\GioiMon-Backend\gm-user\src\main\java\hust\project\gioimon\gm_user\service\exceptions\custom\UsernameExistedException.java", "Java", 0, 0, 6, 0, 0, 0, 3, 9
"h:\HUST\Thesis\GioiMon-Backend\gm-user\src\main\java\hust\project\gioimon\gm_user\service\model\dto\request\AddCoinReqDTO.java", "Java", 0, 0, 14, 0, 0, 0, 3, 17
"h:\HUST\Thesis\GioiMon-Backend\gm-user\src\main\java\hust\project\gioimon\gm_user\service\model\dto\request\LoginRequestDTO.java", "Java", 0, 0, 13, 0, 0, 0, 3, 16
"h:\HUST\Thesis\GioiMon-Backend\gm-user\src\main\java\hust\project\gioimon\gm_user\service\model\dto\response\CheckPermissionDTO.java", "Java", 0, 0, 13, 0, 0, 0, 3, 16
"h:\HUST\Thesis\GioiMon-Backend\gm-user\src\main\java\hust\project\gioimon\gm_user\service\model\dto\response\CoinDTO.java", "Java", 0, 0, 9, 0, 0, 0, 3, 12
"h:\HUST\Thesis\GioiMon-Backend\gm-user\src\main\java\hust\project\gioimon\gm_user\service\model\dto\response\LoginResponseDTO.java", "Java", 0, 0, 14, 0, 0, 0, 3, 17
"h:\HUST\Thesis\GioiMon-Backend\gm-user\src\main\java\hust\project\gioimon\gm_user\service\model\entity\Profile.java", "Java", 0, 0, 34, 0, 0, 0, 4, 38
"h:\HUST\Thesis\GioiMon-Backend\gm-user\src\main\java\hust\project\gioimon\gm_user\service\model\entity\User.java", "Java", 0, 0, 32, 0, 0, 0, 3, 35
"h:\HUST\Thesis\GioiMon-Backend\gm-user\src\main\java\hust\project\gioimon\gm_user\service\repository\jdbc\BaseRepository.java", "Java", 0, 0, 52, 0, 0, 0, 3, 55
"h:\HUST\Thesis\GioiMon-Backend\gm-user\src\main\java\hust\project\gioimon\gm_user\service\repository\jdbc\ProfileRepository.java", "Java", 0, 0, 7, 0, 0, 0, 4, 11
"h:\HUST\Thesis\GioiMon-Backend\gm-user\src\main\java\hust\project\gioimon\gm_user\service\repository\jdbc\UserRepository.java", "Java", 0, 0, 58, 0, 0, 0, 7, 65
"h:\HUST\Thesis\GioiMon-Backend\gm-user\src\main\java\hust\project\gioimon\gm_user\service\repository\jpa\UserInfoRepository.java", "Java", 0, 0, 9, 0, 0, 0, 4, 13
"h:\HUST\Thesis\GioiMon-Backend\gm-user\src\main\java\hust\project\gioimon\gm_user\service\service\ActionCoinService.java", "Java", 0, 0, 16, 0, 0, 0, 3, 19
"h:\HUST\Thesis\GioiMon-Backend\gm-user\src\main\java\hust\project\gioimon\gm_user\service\service\AuthenticationService.java", "Java", 0, 0, 7, 0, 0, 0, 4, 11
"h:\HUST\Thesis\GioiMon-Backend\gm-user\src\main\java\hust\project\gioimon\gm_user\service\service\AuthenticationServiceImpl.java", "Java", 0, 0, 59, 0, 0, 6, 5, 70
"h:\HUST\Thesis\GioiMon-Backend\gm-user\src\main\java\hust\project\gioimon\gm_user\service\service\GlobalService.java", "Java", 0, 0, 28, 0, 0, 1, 3, 32
"h:\HUST\Thesis\GioiMon-Backend\gm-user\src\main\java\hust\project\gioimon\gm_user\service\service\ProfileService.java", "Java", 0, 0, 17, 0, 0, 0, 4, 21
"h:\HUST\Thesis\GioiMon-Backend\gm-user\src\main\java\hust\project\gioimon\gm_user\service\utils\BaseResponse.java", "Java", 0, 0, 18, 0, 0, 0, 2, 20
"h:\HUST\Thesis\GioiMon-Backend\gm-user\src\main\java\hust\project\gioimon\gm_user\service\utils\GsonUtil.java", "Java", 0, 0, 118, 0, 0, 0, 16, 134
"h:\HUST\Thesis\GioiMon-Backend\gm-user\src\main\java\hust\project\gioimon\gm_user\service\utils\StringUtil.java", "Java", 0, 0, 21, 0, 0, 1, 3, 25
"h:\HUST\Thesis\GioiMon-Backend\gm-user\src\main\java\hust\project\gioimon\gm_user\service\utils\TimeUtil.java", "Java", 0, 0, 6, 0, 0, 0, 2, 8
"h:\HUST\Thesis\GioiMon-Backend\gm-user\src\main\java\hust\project\gioimon\gm_user\service\utils\Validator.java", "Java", 0, 0, 8, 0, 0, 0, 3, 11
"h:\HUST\Thesis\GioiMon-Backend\gm-user\src\main\java\hust\project\gioimon\gm_user\service\utils\token\JWTCreator.java", "Java", 0, 0, 37, 0, 0, 0, 9, 46
"h:\HUST\Thesis\GioiMon-Backend\gm-user\src\main\java\hust\project\gioimon\gm_user\service\utils\token\TokenElements.java", "Java", 0, 0, 31, 0, 0, 0, 7, 38
"h:\HUST\Thesis\GioiMon-Backend\gm-user\src\main\java\hust\project\gioimon\gm_user\service\utils\token\TokenUtil.java", "Java", 0, 0, 16, 0, 0, 0, 5, 21
"h:\HUST\Thesis\GioiMon-Backend\gm-user\src\main\resources\application.properties", "Properties", 9, 0, 0, 0, 0, 4, 2, 15
"h:\HUST\Thesis\GioiMon-Backend\gm-user\src\test\java\hust\project\gioimon\gm_user\GmUserApplicationTests.java", "Java", 0, 0, 9, 0, 0, 0, 5, 14
"Total", "-", 11, 125, 996, 118, 10, 70, 237, 1567