"filename", "language", "Batch", "Java", "Properties", "Docker", "XML", "comment", "blank", "total"
"h:\HUST\Thesis\GioiMon-Backend\gm-story\.mvn\wrapper\maven-wrapper.properties", "Properties", 0, 0, 2, 0, 0, 0, 1, 3
"h:\HUST\Thesis\GioiMon-Backend\gm-story\Dockerfile", "Docker", 0, 0, 0, 10, 0, 0, 1, 11
"h:\HUST\Thesis\GioiMon-Backend\gm-story\mvnw.cmd", "Batch", 118, 0, 0, 0, 0, 51, 37, 206
"h:\HUST\Thesis\GioiMon-Backend\gm-story\pom.xml", "XML", 0, 0, 0, 0, 125, 3, 6, 134
"h:\HUST\Thesis\GioiMon-Backend\gm-story\src\main\java\hust\project\gioimon\gm_story\GmStoryApplication.java", "Java", 0, 30, 0, 0, 0, 0, 4, 34
"h:\HUST\Thesis\GioiMon-Backend\gm-story\src\main\java\hust\project\gioimon\gm_story\InitListStory.java", "Java", 0, 14, 0, 0, 0, 0, 6, 20
"h:\HUST\Thesis\GioiMon-Backend\gm-story\src\main\java\hust\project\gioimon\gm_story\client\check_permission\CheckPermissionAnno.java", "Java", 0, 10, 0, 0, 0, 0, 3, 13
"h:\HUST\Thesis\GioiMon-Backend\gm-story\src\main\java\hust\project\gioimon\gm_story\client\check_permission\CheckPermissionAspect.java", "Java", 0, 50, 0, 0, 0, 1, 7, 58
"h:\HUST\Thesis\GioiMon-Backend\gm-story\src\main\java\hust\project\gioimon\gm_story\client\check_permission\CheckPermissionDTO.java", "Java", 0, 13, 0, 0, 0, 0, 4, 17
"h:\HUST\Thesis\GioiMon-Backend\gm-story\src\main\java\hust\project\gioimon\gm_story\client\exceptions\ErrorsDefinition.java", "Java", 0, 80, 0, 0, 0, 0, 16, 96
"h:\HUST\Thesis\GioiMon-Backend\gm-story\src\main\java\hust\project\gioimon\gm_story\client\exceptions\TypeError.java", "Java", 0, 7, 0, 0, 0, 0, 5, 12
"h:\HUST\Thesis\GioiMon-Backend\gm-story\src\main\java\hust\project\gioimon\gm_story\client\feign_client\PostClient.java", "Java", 0, 17, 0, 0, 0, 0, 4, 21
"h:\HUST\Thesis\GioiMon-Backend\gm-story\src\main\java\hust\project\gioimon\gm_story\client\feign_client\UserClient.java", "Java", 0, 15, 0, 0, 0, 0, 3, 18
"h:\HUST\Thesis\GioiMon-Backend\gm-story\src\main\java\hust\project\gioimon\gm_story\client\model\GetPostStoryRequest.java", "Java", 0, 8, 0, 0, 0, 0, 3, 11
"h:\HUST\Thesis\GioiMon-Backend\gm-story\src\main\java\hust\project\gioimon\gm_story\client\model\ResponseData.java", "Java", 0, 32, 0, 0, 0, 0, 10, 42
"h:\HUST\Thesis\GioiMon-Backend\gm-story\src\main\java\hust\project\gioimon\gm_story\client\model\TopPostStoryResponse.java", "Java", 0, 9, 0, 0, 0, 0, 3, 12
"h:\HUST\Thesis\GioiMon-Backend\gm-story\src\main\java\hust\project\gioimon\gm_story\service\cache\ListStoryCache.java", "Java", 0, 67, 0, 0, 0, 0, 6, 73
"h:\HUST\Thesis\GioiMon-Backend\gm-story\src\main\java\hust\project\gioimon\gm_story\service\constant\Common.java", "Java", 0, 10, 0, 0, 0, 0, 2, 12
"h:\HUST\Thesis\GioiMon-Backend\gm-story\src\main\java\hust\project\gioimon\gm_story\service\constant\FilterConstants.java", "Java", 0, 11, 0, 0, 0, 0, 3, 14
"h:\HUST\Thesis\GioiMon-Backend\gm-story\src\main\java\hust\project\gioimon\gm_story\service\controllers\CategoryController.java", "Java", 0, 24, 0, 0, 0, 0, 5, 29
"h:\HUST\Thesis\GioiMon-Backend\gm-story\src\main\java\hust\project\gioimon\gm_story\service\controllers\ChapterController.java", "Java", 0, 14, 0, 0, 0, 0, 4, 18
"h:\HUST\Thesis\GioiMon-Backend\gm-story\src\main\java\hust\project\gioimon\gm_story\service\controllers\ListStoryController.java", "Java", 0, 75, 0, 0, 0, 0, 6, 81
"h:\HUST\Thesis\GioiMon-Backend\gm-story\src\main\java\hust\project\gioimon\gm_story\service\controllers\StoryController.java", "Java", 0, 31, 0, 0, 0, 0, 3, 34
"h:\HUST\Thesis\GioiMon-Backend\gm-story\src\main\java\hust\project\gioimon\gm_story\service\exceptions\GlobalExceptionHandler.java", "Java", 0, 27, 0, 0, 0, 1, 3, 31
"h:\HUST\Thesis\GioiMon-Backend\gm-story\src\main\java\hust\project\gioimon\gm_story\service\exceptions\custom\ApplicationException.java", "Java", 0, 6, 0, 0, 0, 0, 2, 8
"h:\HUST\Thesis\GioiMon-Backend\gm-story\src\main\java\hust\project\gioimon\gm_story\service\exceptions\custom\UserDoesNotExistException.java", "Java", 0, 6, 0, 0, 0, 0, 2, 8
"h:\HUST\Thesis\GioiMon-Backend\gm-story\src\main\java\hust\project\gioimon\gm_story\service\exceptions\custom\UsernameExistedException.java", "Java", 0, 6, 0, 0, 0, 0, 3, 9
"h:\HUST\Thesis\GioiMon-Backend\gm-story\src\main\java\hust\project\gioimon\gm_story\service\model\AuthorDTO.java", "Java", 0, 13, 0, 0, 0, 0, 3, 16
"h:\HUST\Thesis\GioiMon-Backend\gm-story\src\main\java\hust\project\gioimon\gm_story\service\model\CategoryDTO.java", "Java", 0, 14, 0, 0, 0, 0, 3, 17
"h:\HUST\Thesis\GioiMon-Backend\gm-story\src\main\java\hust\project\gioimon\gm_story\service\model\ChapterDTO.java", "Java", 0, 18, 0, 0, 0, 0, 4, 22
"h:\HUST\Thesis\GioiMon-Backend\gm-story\src\main\java\hust\project\gioimon\gm_story\service\model\ContentDTO.java", "Java", 0, 17, 0, 0, 0, 0, 4, 21
"h:\HUST\Thesis\GioiMon-Backend\gm-story\src\main\java\hust\project\gioimon\gm_story\service\model\DetailStoryDTO.java", "Java", 0, 19, 0, 0, 0, 0, 4, 23
"h:\HUST\Thesis\GioiMon-Backend\gm-story\src\main\java\hust\project\gioimon\gm_story\service\model\HistoryDTO.java", "Java", 0, 13, 0, 0, 0, 0, 3, 16
"h:\HUST\Thesis\GioiMon-Backend\gm-story\src\main\java\hust\project\gioimon\gm_story\service\model\HistoryStory.java", "Java", 0, 15, 0, 0, 0, 0, 3, 18
"h:\HUST\Thesis\GioiMon-Backend\gm-story\src\main\java\hust\project\gioimon\gm_story\service\model\SampleStoryDTO.java", "Java", 0, 22, 0, 0, 0, 0, 4, 26
"h:\HUST\Thesis\GioiMon-Backend\gm-story\src\main\java\hust\project\gioimon\gm_story\service\repository\AuthorRepository.java", "Java", 0, 15, 0, 0, 0, 0, 3, 18
"h:\HUST\Thesis\GioiMon-Backend\gm-story\src\main\java\hust\project\gioimon\gm_story\service\repository\BaseRepository.java", "Java", 0, 99, 0, 0, 0, 9, 4, 112
"h:\HUST\Thesis\GioiMon-Backend\gm-story\src\main\java\hust\project\gioimon\gm_story\service\repository\CategoryRepository.java", "Java", 0, 23, 0, 0, 0, 0, 4, 27
"h:\HUST\Thesis\GioiMon-Backend\gm-story\src\main\java\hust\project\gioimon\gm_story\service\repository\ChaptersRepository.java", "Java", 0, 70, 0, 0, 0, 0, 4, 74
"h:\HUST\Thesis\GioiMon-Backend\gm-story\src\main\java\hust\project\gioimon\gm_story\service\repository\ListStoriesRepository.java", "Java", 0, 114, 0, 0, 0, 1, 6, 121
"h:\HUST\Thesis\GioiMon-Backend\gm-story\src\main\java\hust\project\gioimon\gm_story\service\repository\StoryRepository.java", "Java", 0, 50, 0, 0, 0, 0, 6, 56
"h:\HUST\Thesis\GioiMon-Backend\gm-story\src\main\java\hust\project\gioimon\gm_story\service\scheduling\ScheduleProcessor.java", "Java", 0, 4, 0, 0, 0, 0, 2, 6
"h:\HUST\Thesis\GioiMon-Backend\gm-story\src\main\java\hust\project\gioimon\gm_story\service\scheduling\ScheduleUpdateStory.java", "Java", 0, 11, 0, 0, 0, 0, 2, 13
"h:\HUST\Thesis\GioiMon-Backend\gm-story\src\main\java\hust\project\gioimon\gm_story\service\scheduling\Scheduler.java", "Java", 0, 15, 0, 0, 0, 0, 4, 19
"h:\HUST\Thesis\GioiMon-Backend\gm-story\src\main\java\hust\project\gioimon\gm_story\service\scheduling\UpdateChapterProcessor.java", "Java", 0, 34, 0, 0, 0, 0, 6, 40
"h:\HUST\Thesis\GioiMon-Backend\gm-story\src\main\java\hust\project\gioimon\gm_story\service\scheduling\UpdateViewsProcessor.java", "Java", 0, 33, 0, 0, 0, 0, 6, 39
"h:\HUST\Thesis\GioiMon-Backend\gm-story\src\main\java\hust\project\gioimon\gm_story\service\service\CategoryService.java", "Java", 0, 9, 0, 0, 0, 0, 4, 13
"h:\HUST\Thesis\GioiMon-Backend\gm-story\src\main\java\hust\project\gioimon\gm_story\service\service\ChapterService.java", "Java", 0, 11, 0, 0, 0, 0, 5, 16
"h:\HUST\Thesis\GioiMon-Backend\gm-story\src\main\java\hust\project\gioimon\gm_story\service\service\FilteredListStoriesService.java", "Java", 0, 13, 0, 0, 0, 0, 7, 20
"h:\HUST\Thesis\GioiMon-Backend\gm-story\src\main\java\hust\project\gioimon\gm_story\service\service\StoryService.java", "Java", 0, 10, 0, 0, 0, 0, 4, 14
"h:\HUST\Thesis\GioiMon-Backend\gm-story\src\main\java\hust\project\gioimon\gm_story\service\service\impl\AuthorService.java", "Java", 0, 14, 0, 0, 0, 0, 4, 18
"h:\HUST\Thesis\GioiMon-Backend\gm-story\src\main\java\hust\project\gioimon\gm_story\service\service\impl\CategoryServiceImpl.java", "Java", 0, 20, 0, 0, 0, 0, 4, 24
"h:\HUST\Thesis\GioiMon-Backend\gm-story\src\main\java\hust\project\gioimon\gm_story\service\service\impl\ChapterServiceImpl.java", "Java", 0, 29, 0, 0, 0, 0, 6, 35
"h:\HUST\Thesis\GioiMon-Backend\gm-story\src\main\java\hust\project\gioimon\gm_story\service\service\impl\FilteredListStoriesServiceImpl.java", "Java", 0, 198, 0, 0, 0, 0, 25, 223
"h:\HUST\Thesis\GioiMon-Backend\gm-story\src\main\java\hust\project\gioimon\gm_story\service\service\impl\StoryServiceImpl.java", "Java", 0, 50, 0, 0, 0, 0, 5, 55
"h:\HUST\Thesis\GioiMon-Backend\gm-story\src\main\java\hust\project\gioimon\gm_story\service\utils\BaseResponse.java", "Java", 0, 18, 0, 0, 0, 0, 2, 20
"h:\HUST\Thesis\GioiMon-Backend\gm-story\src\main\java\hust\project\gioimon\gm_story\service\utils\Validator.java", "Java", 0, 4, 0, 0, 0, 0, 3, 7
"h:\HUST\Thesis\GioiMon-Backend\gm-story\src\main\java\hust\project\gioimon\gm_story\service\utils\token\JWTCreator.java", "Java", 0, 40, 0, 0, 0, 0, 9, 49
"h:\HUST\Thesis\GioiMon-Backend\gm-story\src\main\java\hust\project\gioimon\gm_story\service\utils\token\TokenElements.java", "Java", 0, 31, 0, 0, 0, 0, 7, 38
"h:\HUST\Thesis\GioiMon-Backend\gm-story\src\main\java\hust\project\gioimon\gm_story\service\utils\token\TokenUtil.java", "Java", 0, 15, 0, 0, 0, 0, 5, 20
"h:\HUST\Thesis\GioiMon-Backend\gm-story\src\main\resources\application.properties", "Properties", 0, 0, 10, 0, 0, 4, 3, 17
"h:\HUST\Thesis\GioiMon-Backend\gm-story\src\test\java\hust\project\gioimon\gm_story\GmStoryApplicationTests.java", "Java", 0, 9, 0, 0, 0, 0, 5, 14
"Total", "-", 118, 1632, 12, 10, 125, 70, 325, 2292